111111111111111111111111111111111111111111111111111111111111111111111111111111111111111111111111111111111111111111111111
111111111111111111111111111111111111111111111111111111111111111111111111111111111111111111111111111111111111111111111111
111111111111111111111111111111111111111111111111111111111111111111111111111111111111111111111111111111111111111111111111
111111111111111111111111111111111111111111111111111111111111111111111111111111111111111111111111111111111111111111111111
111000000000000000000000000000000000000000000000000400000000000000000003000000000000000000032400000000000000000000000111
1110000000000000000000000000000000000000000000000000400000000000000000300000000000000000000111000000000000000000000--111
111000000000000000000000000000000000000000000000000000000000000000000300000000000000000000081900000000000000000000-32111
111000000000000000000000--000000000000000000000000000000000000000000000000000000000000000000000000000000000000000-300111
11100000000000000000000-34---00000000000000000000000000000000000000000000000000000003222400000000000000000000000-3000111
1110000000000000000000032222400000000000000000000000000034-----000000000000000000000--1--0000000000000000000000-30000111
111000000000000000000000000000000000000000000700000000000824000324000000000000000-----1--000000000000000000000-30000-111
1110000007------00--0000000000000000000000---1--0000000000814031900000000000000003222222222222222400000000000030000-3111
1110000032222222002400000000000000000000003222224000000000022222000000000000000--11111111111111100000000-000030000-30111
111000001000000000010000000000000000000-00000000000000000000819000000000000000032222111111111119000000003-00004-00300111
11100000100--000000100000000000000-----7000000000000000000000800000000000000000008111100000000000000000002-00004-0000111
11100000100890000--100000000000000322221----0000000000000000000000000000---00000000000000000000000000000002-000040000111
111000001000000008110000000--0000000811222240000000-0000000000000000000-324000000000000000000000000000000002-0000000-111
111000001--000000000000000034000000000811900000000-7000000000000000000-3221-000000000000000000000000000000002-00000-3111
1110000011900000000000000000000000000000000000000-34--000000000000000-32211400000000000000000000000000000000020000-32111
1110000010000--000--000000000000000000000000000--3222400000000000000-32211900000000000000000000000000000000000000-321111
11100000100008190034---00000000000000000000000-3222224----000000000032211900000000000--0000000000000000000000000-3211111
11100000100000000-32224--0000000000000000000003222222222240000000000000000000-000000034---0000000000000002-0000-32111111
111000001--------3222224000000000000000000000000000011100000000000000000000007-0000000322400000000000000004-000321111111
11100000822222222224111900000000000000000-000000---32224-0000000000000000000014-00000000000000-------0000004-00000000111
11100000000000000811110000000000000000000700000032222222400000000000000000000114-0000000000000322222400000004-0000-00111
1110000000000000000111--0000-00000000000000000000008190000000322400000000000-1114-0000000000001111111000000004-000200111
111000000000000000082222400070000000000000000000000000000000000000000000000-311114-0000000--0011000110000000004-00020111
11140000000000000000000000000000------000000000-0000000000000000000000000003222222400000003400110701100000000004-0002111
1111240000000000000000000000000032222400000000-700000000000000000000000000000011110000000000001100011000000000004-000111
111111000000000000000000000000000000000000000-31-00000000000000000000000000003211000000000000011111110000000000004-00111
11100000000000000000000000000000000000000000031140000000000000000--000000000000000000000000000811111900000000000004-0111
1110000000000000-0000000-00000-000000000000000890000000000000000-34-0000000000000000000340000000000000000000000000040111
1114--0000000000700000007-00--700000000000000000000000000000000-3224-----00000000000003224000000000000000000000000002111
1112220000000000000000003400322400000-------000000--------00000322222222400000000000000811000000000000000000000000000111
1110000000-000000000000010000001000003222224000000320002240000011111111190000000000000008900000000---0000000000000000111
1110000000700000000000001--000010000022211110000001000000100000819000000000000000---000000000000003240000000000000000111
1110000000000000000000001240000100000110002200000010000001000000000000000000000--324000000000000000000000000000000000111
1110000000000000000000001000-0010000011070110000001--000010000000000000000000--3221900-----000000000000---00000000000111
111000000-000000000000008000700100000220001100000022240001000000000000000000032211100032224000---00000032400000000000111
11100000-7--00000000000000008001000001111111000000100000-1000000000000000000--111190000000000032400000000000000000000111
1110000-3124----000000000000000100000811122200000000000032000000000034000000322221000000000000000000000000-0000000000111
11100003222222240000000000032222000000000000000000000000010000-000000000000000008900000000000000000000000070000000000111
11100000111-000000000000000000000000000000000000000000000100007-0000000000000000000000000000-00000----000010000000000111
111000032224---00000000340000000000000000000000000-------1000-14--0000000000000000000000000-300000322400--10000000000111
111000003222222240000000000000000000000000000000003222222200031124000000000000000000000000-31000000000003220000003222111
1110000008111190000000000000000000---0000000000000000000000000000000000000000000000000000-311-00000000000000000000322111
1110000000122400000000000000000000324000000000324000000000000000000000000000000000000000-31114-00000---00000000000031111
1110000000890000003400000000--00000000000000000000000000000000000000-----------00000000-32222240000032400000000000003111
111000000000000003224000000034000000000000000000000000000000000000003222222222400000000322110000000000000000000000000111
11100000000000000000000---0011-0000000000000-000000000000000000000000081111900000000000000824000000000000---000000000111
1110000000000000000000-324--124-00000000000-7-00000000000-00000000-00000000000000000000000000000000000000324000000000111
111000000000000000000032222222240000000000-324-00000000--7-000000-7--00000000000------000000000000000000-111000000000111
11100000000007000000000000111000000000000-32124-00000003224------3222000000000003222240000000000000000003111000000000111
11100000000000000000000---1122--000-0000-3111114-000000000222222220000000000000-1111190000000000000000000122400000000111
111000--0000000000000003222112240007000-322000224000000000000000000000000000000322210000000000000--700000819000000000111
111-0034000000000000000081111190000000-3110000011-0000000000000000000000000000000011-00000-------3210000000000000----111
1114001000000--------0000012240000000-32200000002400000000000000000000000000000000224-0000322222221100000000000003222111
11100-100000032222224000008190000000-3110000000000000000000000000000-------000000001240000111111111900000000000001111111
1110032-000000008190000000000000000-311---------000000000000000000003222224000000000000000819000000000000000000001111111
111---24-0000000000000000000000000-3112222222222222400000000-----0000000000000000000000000000000000000000000000--2241111
112222224000000000000000000000000032221111111111111100000000322240000000000000000000000000000000000000000000000322111111
111222222222222222222222222222222222222222222222222222222222222222222222222222222222222222222222222222222222222222222111
111111111111111111111111111111111111111111111111111111111111111111111111111111111111111111111111111111111111111111111111
111111111111111111111111111111111111111111111111111111111111111111111111111111111111111111111111111111111111111111111111
111111111111111111111111111111111111111111111111111111111111111111111111111111111111111111111111111111111111111111111111